10
1000002001
1000000001
1000000011
1000000011
1000000001
1000000001
1000100001
1101100001
1111100001
1111111111